hasCapital	1-1
isMarriedTo	1-1
wroteMusicFor	1-n
directed	1-n
owns	1-n
edited	1-n
hasAcademicAdvisor	n-1
hasOfficialLanguage	n-1
wasBornIn	n-1
isPoliticianOf	n-1
isCitizenOf	n-1
isInterestedIn	n-1
diedIn	n-1
hasGender	n-1
hasWebsite	n-1
happenedIn	n-n
hasChild	n-n
hasWonPrize	n-n
hasMusicalRole	n-n
actedIn	n-n
exports	n-n
created	n-n
participatedIn	n-n
isLocatedIn	n-n
worksAt	n-n
isLeaderOf	n-n
graduatedFrom	n-n
isConnectedTo	n-n
dealsWith	n-n
influences	n-n
livesIn	n-n
playsFor	n-n
hasNeighbor	n-n
isAffiliatedTo	n-n
